11111111111111
11E0000000C001
101100C0001111
10P00001100001
100C0000100001
11111111111111