11111111111111111111111111
1000000000000100E0C00000C1
10000C001000C0000000000001
1C00C00000C000C0C000000C01
10010C01000C00101001000C01
10C00C10010000010000000011
10000001000000100000100001
1000011010C00C00C00CC00001
10C000000000000000CC0C1011
1C000000C00000000000000001
1000000C1000C000P000CC0001
100000C000000000C100000001
11111111111111111111111111