1111111111
1001001101
100000C0C1
1000000001
100E100C01
100000C001
1000000001
1010010001
1000001PC1
1111111111