11111111101111
111E10PC011111
110C0000011011
11111111111111