11111111111111
111E10PC011111
110C0000011111
11111111111