11111111111111
111110PE011111
11000000011011
11111111111111