11111111111111
011E10PC011111
110C0000011011
11111111111111