11111111111111
100000CCCE0001
11000000000001
1PP00000001101
11111111111111