11111111111111
11111CCCE11111
11000000011011
11111111111111