11111111111111
111E10PC011110
110C0000011011
11111111111111