11111111111111
100000CCCE0001
11000000000001
1P0  000001101
11111111111111