11111111111111
100000CCCE0001
1100000ASD0001
1P0CC000001101
11111111111111