11111111111111
11E110PC011E11
11000000011011
11111111111111