11111111111111
111110PC011111
11000000011011
11111111111111